10 10
##########
#....a...#
#....A...#
#........#
#...##...#
#...##...#
#..@..A..#
#.......a#
#........#
##########

